   XOOX                
   XOOX                
   XOOX                
XXXXOOXXX              
XOOOOOOOX              
XOOOOOOEX              
XOOOOOOOX              
XXXOOOOOX              
XXXOOOOOX              
XOOOOOOOX              
XOOOOOOOX              
XOOOOOXOX              
XOOOOOOOXX             
XXOOOOOOOX             
 XOOOOOOOX             
 XOOOOOOOX             
 XOOXXXOOX             
 XOOOOOOOX             
 XOOOOOOOX             
 XXXXXXXXX             
