XXXXXXXXXXXXXXXXXXXXX
XOOOOOOOOOOOOOOOOOOOX
XOOOOOOEOOOOOOOOOOOOX
XOOOOOOOOOOOOOOOOOOOX
XOOOOOXXXOOOOOOOOOOOX
XOOOOOXXXOOOOOOOOOOOX
XPOOOOXXXOOOEOOOOOOOX
XOOOOOXXXOOOOOOOOOOOX
XOOOOOXXXOOOOOOOOOOOX
XOOOOOOOOOOOOOOOOOOOX
XOOOOOOEOOOOOOOOOOOOX
XOOOOOOOOOOOOOOOOOOOX
XXXXXXXXXXXXXXXXXXXXX
