XXXXXXXXXXXXXXXXXXXXXXXXXX     
XOOOOOOOOOOOOOOOOOOOOOOOOX     
XOOOOOOEOOOOOOOOOOOEOOOOOX     
XOOOOOOOOOOOOOOOOOOOOOOOOX     
XOOOOOXXXOOOOOOOOOXXXOOOOX     
XOOOOOXXXOOOOOOOOOXXXOOOOX     
XPOOOOXXXOOOOEOOOOXXXOOOOX     
XOOOOOXXXOOOOOOOOOXXXOOOOX     
XOOOOOXXXOOOOOOOOOXXXOOOOX     
XOOOOOOOOOOOOOOOOOOOOOOOOX     
XOOOOOOEOOOOOOOOOOOEOOOOOX     
XOOOOOOOOOOOOOOOOOOOOOOOOX     
XOOOOOOOOOOOOOOOOOOOOOOOOX     
XOOOOOOOOOOOOOOOOOOOOOOOOX     
XXXXXXXXXXXXXXXXXXXXXXXXXX     
