                           
XXXXXXXXXXXXXXXXXXXXXXXXXX 
XOOOOOOOOOOOOOOOOOOOOOOOOX 
XOOOOOOOOOOOOOOOOOOOOOOOOX 
XOOOOOOOOOOOOOOOOOOOOOOOOX 
XOOOOOOOOOOOOOOOOOOOOOOOOX 
XOOOOOOOOOOOOOOOOOOOOOOOOX 
XOOOOOOOOOOOOOOOOOOOOOOOOX 
XOOOOOOOOOOOOOOOOXXOXXOOOX 
XOOOOOOOOOOOOOOOXOOXOOXOOX 
XOOOOOOOOOOOOOOOXOOOOOXOOX 
XOOOOOOOOOOOOOOOOXOOOXOOOX 
XOOOOOOOOOOOOOOOOOXOXOOOOX 
XOOOOOOOOOOOOOOOOOOXOOOOOX 
XXXXXXXXXXXXXXXXXXXXXXXXXX 
