                           
XXXXXXXXXXXXXXXXXXXXXXXXXX 
XOOOOOOOOOOOOOOOOOOOOOOOOX 
XOOOOOOOOOOOOOOOOOOOOOOOOX 
XOOOOOOOOOOOOOOOOOOXXOOOOX 
XOOOOOOOOOOOOOOOOOOXXOOOOX 
XOOOOOOOOOOOOOOOOOOOOOOOOX 
XOOOOOOOOOOOOOOOOOOOOOOOOX 
XOOOOOOOOOOOOOOOOOOOOOOOOX 
XOOOOOOOOOOOOOOOOOOOOOOOOX 
XOOOXXXXXOOOOOOOOOXXXXOOOX 
XOOOOOOOOOOOOOOOOOOOOOOOOX 
XOOOOOOOOOOOOOOOOOOOOOOOOX 
XOOOOOOOOOOOOOOOOOOOOOOOOX 
XXXXXXXXXXXXXXXXXXXXXXXXXX 
