XXXXXXXXXXXXXXXXXXXXXXX    
XXXXXXXXXXXXXXXXXXXXXXX    
XOOOOOOOOOOOOOOOOOOOOOX    
XOOOOOOOOOOOOOOOOOOOOOX    
XOOOOOOOOOOOOOOOOOOOOOX    
XOOOOOOOXXOXXOOOOOOOOOX    
XOOOOOOXOOXOOXOOOOOOOOX    
XOOOOOOXOOOOOXOOOOOOOOX    
XOOOOOOOXOOOXOOOOOOOOOX    
XOOOOOOOOXOXOOOOOOOOOOX    
XOOOOOOOOOXOOOOOOOOOOOX    
XOOOOOOOOOOOOOOOOOOOOOX    
XOOOOOOOOOOOOOOOOOOOOOX    
XXXXXXXXXXXXXXXXXXXXXXX    
